NO ./imgs/wooden_wall_chopper.png
SO ./imgs/wooden_wall_nami.png
EA ./imgs/wooden_wall_monkey.png
WE ./imgs/wooden_wall_nico.png

C 9, 24, 51
F 48, 27, 104

11111111111111111111
10000000000000000001
10000000001000110111
10000100001001000001
10000000000011111001
10000000000000000001
10000N00100111111001
11111111100000000001
        111111111111